back0.bmp
30
food.bmp
cristal1.bmp
15   sirka
15  vyska
BBBBBBBBBBBBBBB
B.B.......B...B
B.B.B.BBB.B.B.B
B...B.B.B.B.B.B
B.BBB.B.B.B.B.B
B.B...B.....B.B
BBB.BBBBBBBBB.B
B...B.....BP..B
B.B.B.BBB.B.BBB
B.B.B.B.B.B...B
B.BBB.B.B.BBBBB
B.......B.....B
B.BBBBBBBBBBB.B
B.....B.......B
BBBBBBBBBBBBBCB

